1111111111111111111111111111111111111111
1000000100111110000111100000110000111111
1101110110000000110001101110110111100011
1001010010111111111101101110000011101011
1011011000100000010001000111111000101011
1010001111101101000111010100011010101011
1000101110001101011110010001011010001001
1011101000111111011000110111000010111101
1010101011110001001010110000011110100001
1000001011110101011010111110000000111101
1110111000110100011010001111111011111101
1000111110110111111011101100011000000101
1010000000110000000010001101111010110101
1011110111111111111110111101100010110101
1010100000000101000000111101101000110111
1010111101110101011111110000001010110111
1010010100000000011111110110111010110001
1110110101111011110000000110000000111101
1000110000001011110111111111111111111101
1011110110101110000111100000011111100001
1010000110100000111111101111010001101111
1011110010111011100001101001010101100001
1000111010111111101101101100010101111101
1010111010110000001101101101110101000101
1010011011110111111101101100000101010111
1011011000110110001101101110111101010000
1011011110110000101100100010110101011101
0000000000110111101110101010000100011101
1111111010000111100110001011111111110001
1111111111111111111111111111111111111111
0 540 780 500